legBaseLyrTitle=Temas Base
legLyrTitle=Información contextual
legLyr2Title=Instrumentos de Gestión Territorial
titulo="Plataforma Colaborativa para la Dinamización Económica <br>y Promoción de los Territorios Locales"
tituloShare="Plataforma Colaborativa para la Dinamización Económica y Promoción de los Territorios Locales"
lblFinanciamento=Financiamiento
lblPromotor=Promotor
lblParceiro=Socio
lblAceito=Aceptado
changeCss=Cambiar el color de la aplicación
hidePnlPesqTitle=Mostrar/ocultar panel de búsqueda
doLogin=Comienza la sesión
doLoggout=Cerrar sesión
lblGesConta=Administrar cuenta
btnClear=Limpiar
btnPesquisar=Buscar
titleResultados=Resultados
tabTitlePesquisa=Busquéda
tabTitleEspacos=Espacios
tabTitleValidar=Validación
tabTitleUsers=Usuarios
tabTitleUserMember=Miembros
tabTitleGroups=Grupos
tabTitleNoticias=Noticias
tabTittleOpcoes=Opciones
lblTipoUser=Tipo de usuario
lblAreaGeo=Área geográfica
lblPesquisar=Búscar
fieldMandatoryError=Los campos son obligatorios!
doErrorMsg=Un error se ha producido, por favor intente más tarde
lblEm=en
lblClearSelection=Limpiar la selección
legOrto=Ortofotomapa
legHybr=Híbrido
legVetorial=Vector
newUserTitle=Agregar usuario
editUserTitle=Cambiar los datos del usuario
viewUserTitle=Ver datos del usuario
activateUserBub=Activar usuario seleccionado
createUserTitle=Crear nueva cuenta de usuario
fldNomeUser=Nombre
fldEmailUser=Correo electrónico
fldEstadoUser=Estado de la cuenta
lblNomeUserErro=El campo de nombre es obligatorio!
lblEmailUserErro=El campo de  correo electrónico es obligatorio!
lblDistritoUserErro=El campo de provincia es obligatorio!
lblConcelhoUserErro=El campo de ciudad es obligatorio!
lblEstadoUserErro=El campo de estado es obligatorio!
lblTipoUserErro=El campo tipo de usuario es obligatorio!
lblAreaGeoUserErro=El campo área geográfica es obligatorio!
noUserData=No hay usuarios...
userActivate=Reactivar usuario
userInativo=Inactivo
userAtivo=Activo
userRemovido=Eliminado
userBanido=Baneado
addUserBubble=Añadir nuevo usuario
editUserBubble=Cambiar de usuario seleccionado
rmUserBubble=Eliminar usuario seleccionado
listUserRemoveBubble=Ver lista de usuarios eliminados
viewUserBubble= Ver detalles del usuario seleccionado
optUserBubble=Filtro de búsqueda
msgReativateUser=Quiere reactivar el usuario
userErrorFieldName=El campo de nombre es obligatorio!
userErrorFieldEmail=El campo de  correo electrónico es obligatorio!
userErrorFieldDistrito=El campo de provincia es obligatorio!
userErrorFieldConcelho=El campo de cuidad es obligatorio!
userErrorFieldTipoUser=El campo tipo de usuario es obligatorio!
userErrorFieldAreaGeo=El campo área geográfica es obligatorio!
userErrorFieldAtivo=El campo activo es obligatorio!
userErrorFieldTelemovel=El campo teléfono móvil es obligatorio!
userErrorFieldPass1=El campo contraseña es obligatorio!
userErrorFieldPass2=Debe confirmar la contraseña!
userErrorFieldPassEquals=Contraseñas de acceso no son iguales!
userErrorFieldPassLenght=La contraseña debe contener como mínimo 6 caracteres!
userErrorFieldChkTermos=Tienes que aceptar los términos y condiciones plataforma!
loginTermUso=Acepto los términos y condiciones de uso de la plataforma
loginValUser=El correo electrónico introducido no es válido!
loginValPass=La contraseña no es válida!
loginRecuperaPassMessage=Escribe tu dirección de correo electrónico
userConfirmRegisto=Su cuenta ha sido creada con éxito, usted recibirá un correo electrónico para proceder a su activación
lblGesConta=Administrar Cuenta
lblGesContaBub=Gestión de su cuenta de usuario
gesContaTitle=Gestión de la cuenta de usuario
userOutrasOpcoes=Otras Opciones
userCor=Color favorito
userLang=Idioma preferido
userAlterarPass=Cambiar la contraseña
userRemove=Desactivar cuenta de usuario
userSendMailConfirmUpdateData=Usted recibirá un correo electrónico para confirmar el cambio de datos de la cuenta!
userErrorTelemovelFormat=El número de teléfono móvil no es válido!
userErrorEmailFormat=El correo electrónico no es válido!
userEmailWaitingActivate=Esta dirección de correo electrónico ya está registrada. Espere a que el mensaje de activación!
userEmailBlocking=Esta dirección de correo electrónico está suspendido!
userEmailIsActive=Esta dirección de correo electrónico ya está registrado!
userEmailReativeAccount=Quieres volver a activar su cuenta de usuario?
userAlreadyExists=Este correo electrónico ya está registrado!
titleNewEspaco=Insertar nuevo espacio
titleEditEspaco=Cambio de datos de espacio 
lblSelectTitularidade=Indique cuál es su relación con el espacio
lblSituacaoEspaco=Indique cuál es la situación del Espacio
lblArmazemEncerrado=Almacén Cerrado
lblEscritorioEncerrado=Oficina cerrada
lblLojaEncerrado=Tienda cerrada
lblPavilhaoEncerrado=Pabellón cerrado
titleStreetView=Street View
noInfo=-
fldPeDireitoMaximo=Techo Altura máxima
fldAreaUtil=Área Útil
fldDesignacao=Designación
fldAtividadeEco=Actividad Económica
fldMorada=Dirección
fldRua=Nombre de la calle
fldNumPolicia=Número de Puerta
fldCodPostal=Código Postal
fldAnoFecho=Año de cierre
fldRedeTransport=Distancia à la rede de transportes (m)
fldLocalidade=Localidad
fldFechado=Cerrado
lblAberto=Espacio Ocupado (Abierto)
lblEncerrado=Espacio disponible (Cerrado)
fldEncerrado=Espacio cerrado
fldNif=Número de Identificación Fiscal
fldFinalidade=Finalidad
fdlFinalidade1=Situación del espacio
fldDistrito=Provincia
fldConcelho=Cuidad
fldFreguesia=Parroquia
lblDe=de
fldValor=Valor (€)
fldAtividadeEcoAnterior=Actividad económica anterior
fldCaracteristicas=Característica
fldArea=Área (m2)
fldPeDireito=Techo Altura máxima (m)
fldNumPisos=Número de pisos
fldQuantWC=Cantidad WC
fldComBalcao=Con el equipo de los muebles
fldComFibra=Con fibra óptica
fldRedeTransport1=Cerca de transporte
fldTipoLic=Tipo de licencia
fldEstacionamento=Aparcamiento
fldAcessibilidade=Accesibilidad
fldMobilidade=Movilidad
fldGestaoDoEspaco=Gestión del Espacio
fldContatoVisivel=Mostrar contactos
fldUrl=Página Web
fldProprietario=Contactos del propietario
fldArrendatario=Contactos del Inquilino
fldContatoEspaco=Contactos del Espacio
fldMediador=Contactos del Mediador
lblProprietario=Propietario
lblArrendatario=Inquilino
lblMediador=Mediador
fldTelefone=Teléfono
fldTelemovel=Teléfono móvil
fldEmail=Correo electrónico
fldFax=Fax
fldSkype=Skype
fldFacebook=Facebook
fldTwitter=Twitter
fldLinkedin=Linkedin
fldFotos=Fotografías
fldContatosEspaco=Contactos del Espacio
fldDocumentos=Documentos
fldObservacoes=Observaciones
fldCreateDate=Fecha de registro
fldUpdateDate=Fecha última variación
fldEstadoValidacao=Validación Estado
lblWaitingVal=En espera
lblAprovedVal=Aprobado
lblRejectVal=Rechazado
fldRejeicao=Motivo de rechazo
fldTipoTitularidade=Tipo de Propiedad
fldEspacoErrorTipoTitularidade=*Indique qué tipo de propiedad del espacio!
fldEspacoErrorEstadoEspaco=*Indique cuál es la situación del espacio!
fldEspacoErrorDesignacao=*El campo designación es obligatorio!
fldEspacoErrorNif=*El campo NIF es obligatorio!
fldEspacoErrorNifLenght=*El NIF introducido no es válido!
fldEspacoErrorLocalidade=*El campo de localidad es obligatorio!
fldEspacoErrorRua=*El campo de la calle es obligatorio!
fldEspacoErrorCodigoPostal=*El calpo del Código Postal es obligatorio!
fldEspacoErrorAtividadeEconomica=*El campo de la Actividad Económica es obligatorio!
fldEspacoGrupoNomeError=*El nombre del grupo es obligatorio!
fldEspacoErrorTeles=**Debe indicar el teléfono y teléfono móvil del espacio!
fldEspacoErrorEmail=*Debe indicar la dirección de correo electrónico del espacio!
fldEspacoErrorTelesProp=**Debe indicar el teléfono o teléfono móvil del proprietáriro del espacio!
fldEspacoErrorEmailProp=*Debe indicar la dirección de correo electrónico del proprietáriro!
fldEspacoErrorTelesArrend=**Debe indicar el teléfono o teléfono móvil del inquilino!
fldEspacoErrorEmailArrend=*Debe indicar la dirección de correo electrónico del  inquilino!
fldEspacoErrorTelesMediador=**Debe indicar el teléfono o teléfono móvil del mediador!
fldEspacoErrorEmailMediador=*Debe indicar la dirección de correo electrónico del mediador!
fldEspacoErrorAnoFecho=*El campo año de cierre es obligatorio!
fldEspacoErrorFinalidade=*El campo finalidad es obligatorio!
fldEspacoErrorValor=*El campo valor es obligatorio!
fldEspacoErrorPisos=*El campo número de pisos es obligatorio!
fldEspacoErrorPeDireito=*El campo área es obligatorio!
fldEspacoErrorQuantWC=*El campo cantidad Wc es obligatorio!
fldEspacoErrorArea=*El campo área es obligatorio!
fldEspacoErrorTipoLic=*El campo tipo de licencias és obligatorio!
fldEspacoErrorAcessibilidade=*El campo accesibilidad és obligatorio!
fldEspacoErrorMobilidade=*El campo movilidad és obligatorio!
fldEspacoErrorParque=*El campo disponible parque és obligatorio!
fldEspacoErrorPropNotProp=*Debe indicar si es o no propietario!
espacoNoInfoAvailable=Información no disponible
espacoAddFoto=Quieres añadir una foto al espacio?
outrasAlteracoes=*Otros cambios
geomAlterado=-La ubicación del espacio ha sido cambiado
fotosAlterado=-Las fotografías desde el espacio han cambiado
docsAlterado=-Los documentos espacio han cambiado
addEspacoBub=Añadir nuevo espacio
editEspacoTitle=Editar datos de lo espacio
editEspacoBub=Edite el espacio seleccionado
gestFotoEspacoBub=Administrar fotos de lo espacio seleccionado
gestDocEspacoBub=Administrar documentos de lo espacio seleccionado
removeEspacoBub=Eliminar el espacio seleccionado
viewEspacoBub=Ver los detalles de lo espacio seleccionada
viewEspaco=Ver detalles del espacio
refreshEspacoBub=Actualizar la lista de espacios
searchEspacoBub=Buscar espacios
clearSearchEspacoBub=Limpiar la búsqueda
confirmRemoveEspacoMessage=Confirma la eliminación del espacio
lblEspacoNoResult=No hay espacios...
newFotoBub=Añadir una foto
delFotoBub=Eliminar foto seleccionada
defFotoBub=Establecer como fotografía principal
confirmDefaultFotoMessage=Establecer foto seleccionada como la foto principal
lblNoFotoResult=No hay imágenes
titleGestFotos=Gestión de Fotos
confirmDelFoto=Confirma la eliminación de la imagen seleccionada
gestDocTitle=Gestión Documental
uploadDocTitle=Upload de Documento
lblDocInfoUpload=Puede adjuntar un documento al espacio para que pueda ser validado. (Este documento es sólo visible para el administrador).
lblDocInfoUploadAlert=Usted desea adjuntar un documento al espacio?
newDocBub=Añadir documento
delDocBub=Eliminar el documento seleccionado
viewDocBub=Ver el documento seleccionado
lblNoDocResult=No hay documentos
confirmDelDoc=Confirma la eliminación del documento seleccionado
fldDescricaoDocumento=Descrición del documento
fldTipoDocumento=Ver
errorDocumentExist=Ya existe el tipo de documento seleccionado!
errorMandatoryTipoDoc=El campo de tipo de documento es obligatorio!
titleCompareEspaco=Comparar Espacio
validateEspacoBub=Validar la información del espacio seleccionado
rejectEspacoBub=Rechazar la información del espacio seleccionado
noResultVal=No existen espacios para la validación...
confirmValidateEspacoMessage=Seguro que desea validar el espacio de información
confirmRejectEspacoMessage=Seguro que deseas rechazar el espacio de información
noResultValidation=No existen espacios para la validación...
rejeicaoTitle=Rechazar los datos del espacio
lblRejeicaoMotivo=Por favor, indique la razón del rechazo de datos espaciales
lblErroRejeicaoMotivo=La razón para el rechazo es obligatorio!
lblErroRejeicaoMotivoExceed=Sólo 250 caracteres están permitidos!
lblValidar=Validar
lblRejeitar=Rechazar
lblAssinalarCampo=Indicar campo
lblRejectedFields=(*) Los campos rechazadas
lblTransferirEspacoValidacao=Esperar la validación de la transferencia
lblValidarEspacoValidacao=Esperar validación
lblPesquisaNoResult=No existen espacios de acuerdo a sus criterios de búsqueda.
lblPesqMandatoryFields=Debe designar al menos un criterio de búsqueda!
noResultSearch=No hay espacios de acuerdo a sus criterios de búsqueda.
exportEspacoTitle=Exportar espacios
selectWhatExport=Seleccione el tipo de información a exportar
downloadHistoricEspaco=Descarga espacios históricos
downloadAllEspaco=Descargar todos los espacios
gestInfoContextTitle=Gestión de la información de contexto
selectFormatExport=Haga clic en el formato de informacion a exportar
exportShpTitle=Exportar en Shapefile
exportXLSTitle=Exportar en Excel
exportKMLTitle=Exportar en KML
exportDxfTitle=Exportar en CAD
exportGpxTitle=Exportar en GPX
exportShpHistTitle=Exportar historial en formato Shapefile
exportXLSHistTitle=Exportar historial en formato Excel
exportKMLHistTitle=Exportar historial en formato KML
exportGpxHistTitle=Exportar historial en formato GPS
exportDxfHistTitle=Exportar historial en formato CAD
lblSelectTema=Seleccione un tema
lblSelectSubTema=Seleccione un subtema
ElemExpListTitle=Lista de
addElemExpBub=Añadir nuevo elemento
editElemExpBub=Editar elemento seleccionado de la información
delElemExpBub=Eliminar el elemento seleccionado
viewElemExpBub=Ver elemento seleccionado
elemexpNoResult=Este sub-tema no tiene registro
lblSim=Sí
lblNao=No 
lblSubmeter=OK
lblSeguinte=Siguiente
lblAnterior=Anterior
btnValidar=Validar
lblNoEspacoCompare=Este espacio no tiene datos de comparación.
lblCamposAlterados=(*)Los campos modificados
loginPassAtual=Contraseña de acceso actual
loginPassNova=Nueva contraseña
loginPassConfirmNova=Repita la nueva contraseña
loginPassEquals=Las contraseñas no coinciden
fldMandatoryError=Debe rellenar todos los campos requeridos
fldSpacialSearch=Búscar espacios
fldSelAreaGeo=Zona geográfica de la selección en el mapa
mapTDrawPt=Dibuja punto en el mapa
mapTDrawLine=Dibujar línea en el mapa
mapTDrawPoly=Dibuja polígono en el mapa
fldClearMapGeo=Limpiar mapa
fldClear=Limpiar
fldValorMin=de
fldValorMax=a
fldOutrasCarateristicas=Otras características
clearMapGeo=Limpiar Área geográfica clara de la selección en el mapa
loginCurrentPass=Contraseña de acceso actual
btnSave=Guardar
btnRegistar=Registrar
btnCancel=Cancelar
lblClose=Cerca
lblMove=Movimiento
loginUser=Correo electrónico
loginPass=Acceso Contraseña
loginPassConfirm=Confirmar contraseña
loginForgetPass=Olvidé mi contraseña
msgConfirmRecPwd=Su petición se ha realizado correctamente. Usted recibirá un correo electrónico para cambiar la contraseña.
loginRegisto=Crear cuenta
loginSubmit=Entrar
loginNome=Nombre
noFileUploadFound=Error, archivo no encontrado!
uploadFailed=El archivo de carga no tuvo éxito!
errorInsertData=Se ha producido un error al guardar los datos!
errorPermition=No tiene permiso para realizar esta operación!
maxUploadExced=Archivo con tamaño mayor que el tamaño máximo permitido!
filePDFRestriction=Sólo se permiten archivos en formato PDF
fileJPGRestriction=Sólo se permiten archivos en formato JPG
filePNGRestriction=Sólo se permiten archivos en formato PNG
noFileUpload=No ha seleccionado ningún archivo para subir!
uploadFotoTitle=Subir Foto
maxUploadSize=El tamaño máximo de los archivos para subir: 1 MB
mapTPanLbl=Mover el  mapa
mapTZoomInLbl=Ampliar
mapTZoomOutLbl=Reduzir
mapTFullExtLbl=Extensión total del mapa
mapTZoomPrevLbl=Vuelve a la posición anterior
mapTZoomNextLbl=Volver a la posición siguiente
mapTMessDistLbl=Mida la distancia en el mapa
mapTMessAreaLbl=Área de medición en el mapa
mapTInfoLbl=Obtener información sobre el mapa
measureArea=Área
measureDistancia=Distancia
refresh=Actualización
recPwdKeyExpired=La solicitud de restablecimiento de contraseña caducada!
msgErrorChangePwd=Contraseña anterior incorrecta!
msgInvalidEmailAddress=El correo electrónico no es válido!
invalidInvocation=Invocación no válido!
invalidParameters=Parámetros no válidos!
foraAreaGeo=La localizacion seleccionada se encuentra fuera del area permitida!
limitExceedAreaGeo=El ajuste de la localizacion esta permitida para una distncia inferior a la solicitada, si se verifica que esa tolerancia no es suficiente, contacte com el  administrador.
confirmHeader=Confirmar
confirmNo=No
confirmYes=Sí
lblAtention=Atención
msgConfirmChangePwd=Su contraseña se ha cambiado correctamente
msgConfirmActivateAccount=A sua conta de utilizador foi ativada com sucesso.
msgConfirmChangeAccount=A sua conta de utilizador foi modificada com sucesso.
msgRejectActivateAccount=Não foi possível ativar a sua conta de utilizador. Tente mais tarde.
msgRejectChangeAccount=Não foi possível concluir a alteração dos dados da conta de utilizador. Tente mais tarde.
maskExpiredSession=Su sesión ha caducado...
maskPesquisa=Buscar...
maskRefresh=Actualizar...
maskProcessRequest=Procesar...
maskFotoEspacoLoad=Cargando fotos desde el espacio...
maskDocEspacoLoad=Cargando documentos do espacio...
maskInitSession=Inicio de sesión...
maskActivatingAccount=Por favor espere mientras activamos su cuenta de usuario...
maskshareEspacoFacebook=Compartir el espacio seleccionado en Facebook
shareEspacoTwitter=Compartir el espacio seleccionado en Twitter
shareEspacoBubFacebook=Compartir espacio en Facebook
shareEspacoBubTwitter=Compartir espacio en Twitter
shareEspacoLinkedin=Compartir el espacio seleccionado en Linkedin
shareEspacoGoogle=Compartir el espacio seleccionado en Google+
printPesquisa=Imprimir Buscar
noDataShow=No hay datos para mostrar
titleGestParam=Cambiar la visibilidad de
gestParamThemeTitle=Configuración de visibilidad
selectParamToConfig=Seleccione el parámetro establecido
inEmailDest=Ingrese correo electrónico del destinatario:
permissionDenied=Lo sentimos, no tenemos permiso para realizar esta operación...
transferEspacoTitle=Transferencia de Espacio
docToConfirmTransfer=Introduzca un documento para la transferencia del espacio.
errorMandatoryTransMotivo=Se requiere Las razones para el campo de la transferencia!
errorMandatoryUserTo=Debe indicar el correo electrónico del destinatario!
errorMandatoryDescricaoFicheir=Se requiere el campo descrición del documento
transferAlertOK=Su petición se ha efectuado con éxito
espacoStateWaitingValidionEdit=Los cambios a la espera de la validación
espacoStateWaitingValidionTransfer=Espera a la transferencia de validación de usuarios
espacoStateReject=Cambios/Transferencia rechazados
espacoStateValidat=Espacio Validado
espacoStateAproved=Espacio aprobado
grupoWaiting=En espera de la moderación
gruposStateReject=Grupo rechazado
grupoStateAproved=Grupo aprobado
titleeRejectEspacoTransfer=Rechazar la transferencia de espacio
fieldMandatoryRejectEspacoTransfer=Campo requerido!
loteamentos=Las Zonas de Actividades Económicas
backToIntro=Volver a la página inicial
consultarInfoIGTS=Consulte la información de IGTS
searchByDesignacaoAndNif=Nombre, NIF
registerBy=Registrado por
viewUserGroupBuble=Ver detalles del grupo seleccionado
validateUserGroupBuble=Validar grupo seleccionado
rejectUserGroupBuble=Rechazar grupo seleccionado
addUserGroupBuble=Añadir grupo de usuarios
editUserGroupBuble=Editar grupo seleccionado
removeUserGroupBuble=Eliminar grupo seleccionado
userGroupNoData=No hay grupos de usuarios
userGroupNoDataVal=No hay grupos de usuarios para validar
addNoticia=Añadir notícias seleccionadas
editNoticia=Editar noticias seleccionadas
delNoticia=Eliminar noticias seleccionadas
gestFotoNoticia=Gestión de fotos de noticias seleccionados
viewNoticia=Ver noticia seleccionada
refreshListData=Actualizar la información del panel
searchTxtFindUser=Nombre, Correo electrónico
lblLocalizacao=Localización 
fldMetawords=Palabras clave
fldMetawordsExample=Debe indicar palabras clave para la búsqueda más fácil, por ejemplo Francesinha, zapatos, Bolt, Coche, Ordenador
favoriteRemove=Retire el espacio seleccionado de los favoritos
favorite=Favoritos
printEspaco=Imprimir espacio 
printPesquisaTitle=Informe de investigación
printEspacoTitle=Información del espacio
sendMailTitle=Enviar correo electrónico
sendBtn=Enviar
remetente=Remitente
destinatario=Receptor
mensagem=Mensaje
sendMailErrorFieldNomeTo=El campo nombre del destinatario es obligatorio!
sendMailErrorFieldEmailTo=El campo destinatario de correo electrónico es obligatorio!
sendMailErrorFieldNomeFrom=El campo nombre del remitente es obligatorio!
sendMailErrorFieldEmailFrom=El remitente del campo de correo electrónico es obligatorio!
sendMailErrorFieldMensagem=El campo mensaje es obligatorio!
addPreferenciaPesquisaTitle=Añadir una nueva encuesta de preferencias.
editPreferenciaPesquisaTitle=Editar preferencias de búsqueda seleccionada.
removePreferenciaPesquisaTitle=Eliminar preferencias de búsqueda seleccionada
viewPreferenciaPesquisaTitle=Mostrar preferencia de búsqueda seleccionada
noPreferenciaPesquisaData=No hay preferencias de búsqueda...
tabFavoritosTitle=Favoritos
tabPreferenciaPesquisaTitle=Pretensiones
pretencaoLabelFooter=Si usted no puede encontrar lo que busca, guardar aquí su búsqueda. Sera notificado cuando esté disponible.
warningAddPreferenciaPesquisa=Explore el área donde desea recibir advertencias.
fldTipologiaEspaco=Tipología
messageConfirmSavePesqPretencao=Quieres ser notificado tan pronto como se produce un cambio en el mercado de acuerdo a su criterio?
pretencaoTitle=Pretensión
pretencaoAddTitle=Añadir pretensión
pretencaoEditTitle=Editar pretensión
pretencaoDelConfirm=Confirma la eliminación de la pretensión seleccionado?
sendedMail=El correo electrónico ha sido enviado!
sendMailFailed=Lo sentimos, no fue posible para enviar correo electrónico!
addMemberIn=Añadido el
addNewMemberBub=Agregar un nuevo miembro
delMemberBub=Retire miembro seleccionado
delMeMemberBub=Salir de grupo
valMemberBub=Acepta el miembro
rejMemberBub=Rechazar miembro
searchMemberBub=Buscar miembro
noMemberData=No existe un grupo creado
viewMemberSel=Ver datos del miembro seleccionado
frmSugestaoTitle=Enviar sugerencias
frmShareEspaco=Compartir el espacio en
sendedSugestao=Su sugerencia fue enviado con éxito. Gracias!
lblTema=Tema
lblElemento=Elemento
listCaeTitle=Actividades Económicas
lblSeccaoCae=Seleccione una sección
lblDivisaoCae=Seleccione la división
lblGrupoCae=Seleccione el grupo
lblClasseCae=Seleccionar la clase
lblSubClasseCae=Seleccione el CAE
createGrupoUsers=Crear grupo de usuarios
lblDesignacaoGrupo=Designación del grupo
lblChkGrupoVisivel=Hacer que el grupo visible para otros usuarios
joinGrupoRequestSuccess=Su petición se ha realizado con éxito. Usted recibirá una confirmación una vez que haya terminado.
alreadyJoinGrupo=Ya es miembro del grupo seleccionado!
fldGrupoDesignacaoError=El campo de designación es obligatorio!
fldGrupoEspacoError=Deberá indicar el espacio referencia del grupo!
notPermitionToChangeGroup=No se le permite hacer cambios en el grupo seleccionado!
fldGrupoEspRef=Espacio del referencia
fldGrupoUserRef=Responsable
fldGrupoEspRefTitle=El espacio de referencia es el espacio que representa el grupo
fldGrupoDados=Datos del grupo
fldNumeroMembros=Número de miembros
fldPublico=Público
viewGrupoTitle=Ver datos de grupo de Usuarios
addGrupoTitle=Añadir grupo de usuarios
editGrupoTitle=Editar Grupo de Usuarios
confirmDelGrupoSel=Confirma la eliminación del grupo seleccionado
lblSelectEspacoImobiliaria=Seleccione la zona en la que se encuentra la inmobiliária
lblSelectEspacoAssociacao=Seleccione la zona donde se encuentra la asociación
aprovarMembro=Aprobar miembro seleccionado
rejeitarMembro=Rechazar miembro seleccionado
viewMembro=Ver miembro seleccionado
viewMembroTitle=Ver miembro
confirmAcceptMember=Quieres que confirme la solicitud de adhesión al grupo?
rejectAcceptMember=Quieres que rechace la solicitud de adhesión al grupo?
anexarEspacoAGrupo=Quieres adjuntar un espacio para un grupo?
selEspacoAGrupo=Seleccione el grupo
fullscreenTitle=Entrar/salir del modo de pantalla completa
insertNoticiaTitle=Insertar noticias
editNoticiaTitle=Editar noticias seleccionadas
lblSelectTipoNoticia=Tipo de noticias
lblVisibilidadeNotica=Publicar noticias
lblTituloNoticia=Título de noticias
lblDescricaoNoticia=Noticias de contenido
fldErrorTituloPtNotica=El título de la noticia en portugués es obligatorio!
fldErrorDescricaoPtNotica=La descripción de las noticias en portugués es obligatorio!
fldErrorTipoNotica=El tipo de noticias es obligatorio!
Portugues=Portugués
Ingles=Inglés
Espanhol=Español
Alemao=Alemán
informacao=Información
confirmDelNoticia=Confirma la eliminación de las noticias seleccionada?
shareSocialError15Days=Lo sentimos, pero hizo una publicación a menos de 15 días!
naoFoiPossivelConcluirPedido=Lo sentimos, no hemos podido completar su solicitud correctamente!
userRegDesc=Presenta la posibilidad de añadir los espacios registrados en la plataforma como "Favoritos", llevar a cabo el registro de una "Pretensión" y compartirlas en términos de redes sociales.
userEconDesc=Propietario o arrendatario de un espacio registraron en la plataforma con la posibilidad de insertar y gestionar sus espacios.
userImoTitle=Promotor inmobiliario
userRegTitle=Usuario registrado
userEconTitle=Agente económico
userImoDesc=Responsable de la gestión de los espacios cerrados, con la posibilidad de crear y administrar grupos de usuarios asociados a su agencia inmobiliaria.
notPermitTransferEspacoVal=No se pueden transferir los espacios no validados!
localizeEspacoEntradaEdificio=Localizar el espacio relativamente cerca de la entrada del edificio.
Cancelar=Cancelar
cancelarTransferenciaMensage=Confirma la cancelación de la transferencia de espacio?
alreadyJoinAssociacao=Éstos son algunos de los miembros seleccionados!
nomeGrupoPlaceHolder=Nombre del grupo...
nomeAssociacaoPlaceHolder=Nombre de asociación...
joinGrupo=Entrar en el grupo
joinAssociacao=Entrar en la asociación
unJoinGrupo=Salir de grupo
unJoinAssociacao=Salir de la asociación
addUserAssocBuble=Añadir asociación.
editUserAssociacaoBuble=Editar asociación seleccionada.
removeUserAssociacaoBuble=Borrar asociación selecionada.
userAssociacaoNoData=No hay asociaciones ...
fldAssociacaoDados=Datos de la asociación...
fldGrupoPublico=Grupo público
fldAssociacaoPublico=Asociación pública
viewAssociacaoDataTitle=Mostrar datos de la asociación
fldAssociacaoEspacoError=Se debe indicar la ubicación del espacio de la Asociación!
editAssociacaoTitle=Editar asociación seleccionada
rmGrupoBubble=Eliminar grupo seleccionado
rmAssociacaoBubble=Retire asociación seleccionada
notPermitionToChangeAssociacao=No se le permite realizar cambios en la asociación seleccionada!
confirmDelAssociacaoSel=Confirma la eliminación de la asociación seleccionada?
viewAssociacaoBuble=Ver detalles de la asociación seleccionada.
associacaoWaiting=En espera de la validación
associacaoStateReject=Asociación rechazada
associacaoStateAproved=Asociación aprobada
membroTab=Miembros
allGrupoTab=Todos los grupos
myGryposTab=Mis grupos
allAssociacoesTab=Asociaciones
gestAssocTab=Administrar asociación
gestAssociadosTab=La gestión de los asociados
addAssociacaoTitle=Añadir asociación
titleRejectGrupoVal=Rechazar grupo de usuarios
userAtual=Usuario actual
userTo=Receptor
pretencaoTabTitle=Si no encuentras lo que buscas, guardar su búsqueda aquí. Le notificará cuando esté disponible
printGraph=Imprimir gráfico
genGraphBar=Generar gráfico de barras
genGraphLine=Generar gráfico de líneas
genGraphPie=Generar gráfico circular
selectPretendGraph=Seleccione el gráfico deseado
noResultSearchInfo=La búsqueda no arrojó ningún resultado!
needThemeOn=Usted debe tener al menos un tema activo!
selElementToView=Haga clic en el elemento para ver las características...
InfoGeo=La información geográfica
descricaoElemento=Descripción de los objetos...
membroWaiting=Esperando aprobacion
membroValidate=Aprobado
espacoWaitingVal=No se puede realizar esta operación porque el espacio está en proceso de validación. Espere a que concluya el mismo!
browserIsNotCompatible=La plataforma no es compatible con tu versión actual de Internet Explorer!
tipoUserTitle=Tipo de usuario
fldRedeTransport2=Red de transporte (m)
lblMotivoTransfer=Motivo de la transferencia
fldUserDados=Datos del usuario
lblEstado=Estado
pdmCartoRef=Cartografia de base
pdm=Plan Director Municipal
pdmDoc=(ver regulación)
pdmLimite()=Límite del municipio de Trofa 
pdmUOPG()=UOPG
pdmZonasInundaveis()=Zonas inundables
pdmSoloRural()=Suelo Rural 
pdmSoloUrbano()=Suelo Urbano
pdmSoloRuralUrbano()=Suelo Urbano/Rural
pdmAglomeradoRural()=Diseminados rurales
pdmEstruturaEcologica()=Estructutas ecologicas
pdmRuido()=Ruido
pdmRuidoZonasSensíveis()=Zonas sensibles
pdmRuidoZonasMistas()=Zonas mixtas
pdmSREspacoFlorestal()=Espacio florestal
pdmSRAreaFlorestaldeProducao()=Producción florestal
pdmSRAreaFlorestaldeProtecao()=Protección florestal
pdmSREspacoAgricola()=Zonas Agrícolas
pdmSRAglomeradoRural()=Aglomeraciones Agrícolas
pdmSREspacoCultural()=Área Cultural
pdmSRAreaParque()=Área de Parque
pdmSREstacaoArqueologica()=Estación Arqueológica
pdmSRRecursosGeologicos()=Espacio de explotación de recursos geológicos
pdmSUSoloUrbanizado()=Suelo Urbanizado
pdmSUEspacoCentral()=Espacio Central
pdmSUEspacoResidencial()=Espacio Residencial
pdmSUAreaHabitacaoColetiva()=Área de Viviendas Colectivas
pdmSUAreaMoradias()=Viviendas
pdmSUEspacoAtividadesEconomicas()=Espacio de las Actividades Económicas
pdmSUEspacoUsoEspecial()=Espacio de Uso Especial
pdmSUAreaEquipamentoEstruturante()=Área de Equipo Estructurante
pdmSUAreaInfraestruturaEstruturante()=Área de Infraestructura Estructurante
pdmSUEspacoVerde()=Espacio Verde
pdmSUAreaVerdeUtilizacaoColetiva()=Área verde de Uso Colectivo
pdmSUAreaVerdeProtecao()=Área Verde de Protección
pdmSUSoloUrbanizavel()=Suelo Urbanizable
pdmSUSUEspacoResidencial()=Espacio Residencial
pdmSUSUAreaHabitacaoColetiva()=Área de Vivienda Colectiva
pdmSUSUAreaVerdeMoradia()=Área Verde de Viviendas
pdmSUSUEspacoAtividadesColetivas()=Espacio de Actividades Colectivas
pdmSRURodoviario()=Carretero
pdmSRUExistente()=Existente
pdmSRUProposto()=Proposo/Previsto
pdmSRUViasAmbitoRegional()=Vías de Ámbito Regional
pdmSRUViasDistribuidorasPrincipais()=Vías Distribuidoras Principales
pdmSRUViasDistribuidorasSecundarias()=Vías Distribuidoras Secundarias
pdmSRURedeLocal()=Red Local
pdmSRUEstacaoServicos()=Estación de Servicio
pdmSRUFerroviario()=Ferroviario
pdmSRUPesadaSuperficie()=Pesada – Por la Superfície
pdmSRUPesadaTunel()=Pesada – En Túnel
pdmSRUFerroviaLigeira()=Ferrovia Ligera
pdmSRUCiclovia()=Carril Bici
pdmEstEcoSoloRural()=En Suelo Rural
pdmEstEcoSoloUrbano()=En Suelo Urbano
pdmEstEcoRedeHidricaEstruturante()=Red Hídrica Estructurante
submit()=Presentar
exportGraph()=Exportar gráfico
userEditTitle()=Editar título
userAddTitle()=Anadir nuevo título
pretencaoAreaExceeds()=La área de pretensión señalada es demasiado extensa, el máximo permitido es de 50 Ha!
lblVoltar()=Volver
lblPortugues()=Portugués
lblIngles()=Inglés
lblCastelano()=Castellano
lblGalego()=Gallego
lblFrances()=Francés
euPretendo()=Yo Pretendo...
megaPesquisaAlert()=Indique una expresion para buscar…
resultMegaPesquisa()=Resultado de la busqueda Global
tabTitleToponimia()=Toponimia
tabTitleInfraestruturas()=infraestructuras
btnApagar()=Borrar
changeIntroMessageTitle()=Cambiar el mensaje de la pagina inicial
autor()=Autor
fieldErrorDescriptionPt()=El campo descripción portugues debe ser rellenado!
fieldErrorAutor()=El campo autor debe ser rellenado!
changeMessageIntroBar()=Cambiar mensaje de la Pagina Inicial
confirmDelIntroMessage()=Confirma que desea borrar el mensaje de la pagina inicial?
relEnvioMailErro()=El Informe de búsqueda es demasiado grande por  el envío de email!<br/>Por favor reduzca su búsqueda!
fldDesignacaoEspaco()=Nombre de Espacio
shareTitle()=Compartir en
btnShare()=Compartir
viewHistoricoNotificacoesTitle()=Consultar Histórico de Notificaciones
dataEnvio()=Enviado en: 
redesSociaisPnlTitle()=Redes Sociales
selectRedeSocial()=Seleccione la red Social
lblConfigurar()=Configurar
viewHistShareTitle()=Ver histórico de Compartidas
gerarGraficosTitle()=Generar Gráficos
lblRsDesignApp()=Designación de la aplicación
lblRsAppId()=App id
lblRsAppSecret()=App Secret
lblRsPageId()=Page id
lblRsAppKey()=App Key
lblRsClientToken()=Client Token
lblRsSecretToken()=Secret Token
lblRsTestSettingsTittle()=Probar definiciones
lblRsTestSettings()=Por probar las definiciones introducidas haga clic en el botón Probar
lblRsTestBtn()=Probar 
lblRsAlertTesteOk()=Las definiciones introducidas son válidas!
lblRsAlertTesteFail()=Las definiciones introducidas no son válidas.<br>Verifique se han sido introducidas correctamente!
lblRsAlertNoDataDel()=No existe ninguna configuración!
publicadoViaPlataforma()=Publicado vía Plataforma
AlertServiceUnAvailable()=El servicio se encuentra disponible!
AlertShareWithoutPermission()=El servicio se encuentra disponible!
viewManualConfig()=Ver manual de configuración
downloadIconRedesSociais()=Descarga de archivos por configurar
btnTransferirEspacoTitle()=Transferir Espacio
btnCoordenadasTitle()=Coordenadas
btnSelInfoGeoTitle()=Consultar información geográfica
btnRepresentarTitle()=Representar
ViewInfoDetails()=Información del Produto
btnViewInfoDetails()=Ver información del produto
detalhesDoProdutoLbl()=Detalles del Produto
produtoLbl()=Produto
versaoLbl()=Versión
dataLbl()=Fecha
SuporteTecnicoLbl()=Soporte Técnico
SuporteTecnicoLblVal()=Para cualquier question técnica, deberá enviar un email por suporte@cartago.pt señalando en el campo de asunto
noAlertData()=No existen alertas...
removeAlertTitle()=Quitar la alerta seleccionada
viewAlertTitle()=Ver la alerta seleccionada
variosDestinatarios()=Varios Destinatarios...
notificarTitle()=Notificar
assunto()=Asunto
addDestinatario()=Agregar destinatario
delDestinatario()=Quitar destinatario
noDestinatarioData()=No existen destinatarios...
errorAlertDestinatario()=La notificación deberá contener por lo menos uno destinatario!
listDestinatarioList()=Lista de destinatarios
dataPartilha()=Fecha de compartida
 viewDetailsShareSel()=Ver los datos del elemento seleccionado
delDetailsShareSel()=Quitar los datos del elemento seleccionado
noShareData()=No existe histórico de compartidas...
lblShareFotografia()=Fotografia
lblShareUtilizador()=Usuario 
lblShareOutrosDados()=Otros Datos
viewShareLogTitle()=Ver el registro de compartidas
shareConfigFacebookTitle()=Configurar Facebook
shareConfigTwitter()=Configurar Twitter
lblDadosGerais()=Datos Generales
tabAssociacoes()=Asociaciones
addUserToAssociacaoTitle()=Agregar un usuario por la asociación
addUserToAssociacaoBubble()=Agregar un usuario responsable de gestión de la asociación
delUserToAssociacaoTitle()=Quitar usuario
delUserToAssociacaoBubble()=Quitar usuario responsable de gestión de la asociación
lblUserResponsavel()=Usuario responsable:
lblAssociacaoNoResult()=No existen asociaciones
fldEspacoErrorTipoTipologia()=*Indique cual es la tipología del espacio!
confirmRemoveAssociacaoMessage()=Confirma la eliminación de la asociación
lblAssociacao()=Asociacón
lblNumAssociado()=Número de Asociado
lblNumAssociadoFieldMandatory()=El campo número de asociado es obligatorio!
String lblAddAssociados()=Agregar Asociados
btnNew()=Nuevo Registro
btnNewByList=A Partir de la Lista
confirmRemoveAssociadoMessage()=Confirma la eliminación del asociado
editAssociadoTitle()=Editar Asociado
lblFiltrarPorAssociados()=Filtrar por asociados
noGeoElemData()=No existen elementos geográficos para ver
gerirContactos()=Gestionar contactos
addContactoLabel()=Anãdir contacto
addContactoTitle()=Agregar contacto
editContactoLabel()=Cambiar contacto seleccionado
editContactoTtile()=Cambiar contacto 
viewContactoLabel()=Ver contacto seleccionado
viewContactoTtile()=Ver contacto
removeContactoLabel()=Borrar contacto seleccionado
gerirBalcaoEmpreendedor()=Gestionar Acesso al balcón del emprendedor
addBalcaoEmpreendedor()=Agregar Balcón del Emprendedor
editBalcaoEmpreendedor()=Editar balcón dem emprendedor
editBalcaoEmpreendedorSel()=Editar balcón dem emprendedor seleccionado
delBalcaoEmpreendedorSel()=Borrar balcón del emprendedor seleccionado
fldVisivel()=Visible
fldErrorConcelho()=*El campo Municipio es obligatorio!
fldErrorFreguesia()=*El campo de telefono es obligatorio!
fldErrorUrl()=*El campo Url es obligatorio!
balcaoEmpreendedorAlreadyExists()=El Balcón del emprendedor se encuentra ya configurado por este municipio!
noContatoData()=No existen contactos por presentar...
noUserSelected()=No seleccionó cualquier usuario!
lblShareGrupo()=Grupo
warningNoGrupoToAdd()=No se encuentra inscrito en ningún grupo!
espacoNifAlreadyExist()=Existe ya un espacio registrado con este Nif. \n Desea ponerse en contacto con el administrador?
notificarAdminTitle()=Notificar Administrador
newAssociadoTitle()=Agregar espacio de un Asociado
newAssociadoByList()=Buscar por espacio existente
noEspacoWithThisNif()=No se encontró ningún espacio con el NIf indicado!
lblSelectTitularidadeAssociado=Cuál es la relación del asociado con el espacio